EA ./path_to_the_east_texture
F			231, 90         ,90
WE ./path_to_the_west_texture
NO 						./path_to_the_north_texture
SO        ./path_to_the_south_texture
C  121, 1    ,    ,120





        1111111111111111111
1111111110111111111111111 
1111111111111111111111111
100000000011S0000000000001
1011000001110000000000001
10010000000000000000001111111111
1111111111011000001110000000000001
1000000000110000011101111111111111
111101111100000010001
111101111101010010001
110000011100N00010001
10000000000000001100000010001
10000000000000001101010010001
11000001110101011111011110111
11110111 1110101 101111010001
11111111 1111111 111111111111
